Remastered gfx for Tomb Raider NGE version
made by lupus
thx for Sergey Vlasov, Suikaze Raider

resolution:	176x208 fullscreen
format:		GIF indexed to 256 colors

CORE.GIF	better quality CORE logo
NOKIA.GIF	better NOKIA splash
TRBG.GIF	better menu bacground
TRSPLASH.GIF	better legals splash

DELDATA:
CRED4.GIF	better quality "THE END" bg
ENDING.GIF	fullscreen bg from original fmv
HOUSE.GIF	fullscreen bg from render
INTRO.GIF	fullscreen bg from anniversary
LEV1.GIF	fullscreen bg from render
LEV4.GIF	completle redraed fullscreen bg
LEV8A.GIF	fullscreen bg from original fmv
LEV8A_2.GIF	fullscreen bg from original fmv
LEV10A.GIF	fullscreen bg from original fmv
LEV10B.GIF	fullscreen bg from original fmv
LOADING.GIF	better quality loading bg